11
9
12 7 7 7 7 0 0 0 0 0 0
10 6 6 6 6 0 0 0 0 0 0
0 0 0 0 0 0 0 0 0 0 0
0 0 0 0 0 0 0 0 0 0 0
0 0 0 0 0 8 3 3 3 3 0
0 0 0 0 0 10 6 6 6 6 0
3 3 3 3 3 3 3 3 3 3 3
3 3 3 3 3 3 3 3 3 3 3
3 3 3 3 3 3 3 3 3 3 3